A	AH
A(2)	EY
ALARM	AH L AA R M
AN	AE N
AN(2)	AH N
CONNECTED	K AH N EH K T IH D
EASY	IY Z IY
HEY	HH EY
IS	IH Z
JOKE	JH OW K
MUSIC	M Y UW Z IH K
PLAY	P L EY
SCREENSHOT	S K R IY N SH AA T
SEARCH	S ER CH
SET	S EH T
TAKE	T EY K
TELL	T EH L
THE	DH AH
THE(2)	DH IY
WEATHER	W EH DH ER
WEB	W EH B
WHAT	W AH T
WHAT(2)	HH W AH T
WHO	HH UW
